#########################################################
#                                                       #
#   @                                                   #
# ############################## ############## #########
#                                                       #
###################################### #########        #
#                                                       #
# ##################################    #################
# #                                                     #
# # ##################################################### 
#                                                       # 
#   #####################################################
# #                                                     # 
# ###################################################   #
#                                                       # 
#        ################################################
#   $                                                   #
#########################################################